30 26
******************************
******************************
******************************
******************************
*   *   *   *   *   *   *   **
* * * * * * * * * * * * * * **
* * * * * * * * * * * * * * **
* * * * * * * * * * * * * * **
* * * * * * * * * * * * * * **
* * * * * * * * * * * * * * **
* * * * * * * * * * * * * * **
* * * * * * * * * * * * * * **
* * * * * * * * * * * * * * **
* * * * * * * * * * * * * * **
* * * * * * * * * * * * * * **
* * * * * * * * * * * * * * **
* * * * * * * * * * * * * * **
* * * * * * * * * * * * * * **
* * * * * * * * * * * * * * **
* * * * * * * * * * * * * * **
* * * * * * * * * * * * * * **
*I*   *   *   *   *   *   *  O
******************************
******************************
******************************
******************************