30 30
******************************
******************************
******************************
******************************
******************************
******************************
******I                 ******
******                  ******
******                  ******
******                  ******
******                  ******
******                  ******
******                  ******
******                  ******
******                  ******
******                  ******
******                  ******
******                  ******
******                  ******
******                  ******
******                  ******
******                  ******
******                  ******
******                 O******
******************************
******************************
******************************
******************************
******************************
******************************