20 20
********************
*I                 *
*                  *
*                  *
*                  *
*                  *
*                  *
*   ^^^^^^^^^^^^   *
*        ^^        *
*        ^^        *
*        ^^        *
*        ^^        *
*        ^^        *
*   ^^^^^^^^^^^^   *
*                  *
*                  *
*                  *
*                  *
*                 O*
********************